BBBBBBBBBBBBBBBBBBBBBBBBB
B000B00B00000000000000000
B000000000B000B0000000000
B000000000000000000000B00
B0000000000000000B0000000
B00000000B000000000000000
B000000000000B00000000000
B00000000000000000000B000
B00B000000000000000000000
B00000000000000000BBBBBB0
B000000000000000000000000
B0000000B00000000000000B0
B000000000000000000000000
B00000B000000000000000000
B000B00000000000000000BB0
B00000000000000000B000000
B0000B0000000000000000000
B0000000000000000000000B0
B000000B0000000000B000000
BBBBBBBBBBBBBBBBBBBBBBBBB